,Hétfő,Kedd,Szerda,Csütörtök,Péntek,Szombat,Vasárnap
0,0,0,0,0,0,0,0
1,0,0,0,0,0,0,0
2,0,0,0,0,0,0,0
3,0,0,0,0,0,0,0
4,0,0,0,0,0,0,0
5,0,0,0,0,0,0,0
6,0,0,0,0,0,0,0
7,0,0,0,0,0,0,0
8,0,0,0,0,0,0,0
9,1,1,1,1,1,0,0
10,1,1,1,1,1,0,0
11,1,1,1,1,1,0,0
12,1,1,1,1,1,0,0
13,1,1,1,1,1,0,0
14,1,1,1,1,1,0,0
15,1,1,1,1,1,0,0
16,1,1,1,1,1,0,0
17,1,1,1,1,1,0,0
18,1,1,1,1,1,0,0
19,0,0,0,0,0,0,0
20,0,0,0,0,0,0,0
21,0,0,0,0,0,0,0
22,0,0,0,0,0,0,0
23,0,0,0,0,0,0,0
