,Hétfő,Kedd,Szerda,Csütörtök,Péntek,Szombat,Vasárnap
0,14,14,14,14,14,14,14
1,13,13,13,13,13,13,13
2,13,13,13,13,13,13,13
3,13,13,13,13,13,13,13
4,14,14,14,14,14,14,14
5,15,15,15,15,15,15,15
6,16,16,16,16,16,16,16
7,17,17,17,17,17,17,17
8,18,18,18,18,18,17,17
9,19,19,19,19,19,17,17
10,19,19,19,19,19,17,17
11,19,19,19,19,19,17,17
12,19,19,19,19,19,17,17
13,19,19,19,19,19,17,17
14,19,19,19,19,19,17,17
15,19,19,19,19,19,17,17
14,19,19,19,19,19,17,17
17,19,19,19,19,19,17,17
18,19,19,19,19,19,17,17
19,19,19,19,19,19,17,17
20,18,18,18,18,18,17,17
21,17,17,17,17,17,17,17
22,16,16,16,16,16,16,16
23,15,15,15,15,15,15,15
