,Hétfő,Kedd,Szerda,Csütörtök,Péntek,Szombat,Vasárnap
0,13,13,13,13,13,13,13
1,13,13,13,13,13,13,13
2,13,13,13,13,13,13,13
3,13,13,13,13,13,13,13
4,13,13,13,13,13,13,13
5,13,13,13,13,13,13,13
6,13,13,13,13,13,13,13
7,13,13,13,13,13,13,13
8,13,13,13,13,13,13,13
9,13,13,13,13,13,13,13
10,13,13,13,13,13,13,13
11,13,13,13,13,13,13,13
12,13,13,13,13,13,13,13
13,13,13,13,13,13,13,13
14,13,13,13,13,13,13,13
15,13,13,13,13,13,13,13
16,13,13,13,13,13,13,13
17,13,13,13,13,13,13,13
18,13,13,13,13,13,13,13
19,13,13,13,13,13,13,13
20,13,13,13,13,13,13,13
21,13,13,13,13,13,13,13
22,13,13,13,13,13,13,13
23,13,13,13,13,13,13,13
